*XXXXXXXXXXXXXXXXXXXXXXXXXXXXXX
***X*****X*****X**************X
X**X**X**XXXX**X**XXXXXXXXXX**X
X*****X**X*****X***********X**X
XXXXXXX**X**XXXXXXXXXXXXX**X**X
X********X**X**X********X**X**X
X**XXXXXXX**X**X**X**XXXX**X**X
X**X********X*****X********X**X
X**X**XXXXXXX**XXXXXXXXXXXXX**X
X**************X*****X********X
X**X**XXXXXXXXXX**X**XXXX**XXXX
X**X**X*****X*****X********X**X
X**X**X**X**X**XXXXXXXXXXXXX**X
X**X**X**X**X**X*****X********X
X**X**XXXX**X**X**X**X**XXXX**X
X**X********X*****X*****X*****X
X**XXXXXXXXXXXXXXXXXXXXXX**XXXX
X*****X********X********X*****X
XXXX**X**XXXX**X**XXXX**XXXX**X
X*****X*****X********X*********
XXXXXXXXXXXXXXXXXXXXXXXXXXXXXXX
