********XXXXXXXXXXXXX@
XXXXX***XXXXXXXX****XX
XXXXX************XX*XX
XXXXXXXXXXXXX****XX*XX
XXXXXXXXXXXXXXXXX***XX
X*******************XX
X*XXXXXXXXXXXXXXXXXXXX
X*********************