********XXXXXXXXXXXXXX
XXXXX***XXXXXXXX****XX
XXXXX************XX*XX
XXXXXXXXXXXX@****XX*XX
XXXXXXXXXXXXXXXXX***XX
X*******************XX
X*XXXXXXXXXXXXXXXXXXXX
X*********************
