********XXXXXXXXXXXXXX
XXXXX***XXXXXXXX****XX
XXXXX************XX*XX
XXXXXXXXXXXXX****XX*XX
XXXXXXXXXXXXXXXXXXX*XX

XXXXXXXXXXXXXXXXX***XX
X*******************XX
X*XXXXXXXXXXXXXXXXXXXX
X*********************