XXXXXXXXXXXXXXXXXXXXXXXXXXXXXXXXXXXXXXXXXXXXXXXXXXXXXXXXXXXXXXXXXXXXXXXXXXXXXXXXXXXXXXXXXXX
******X*****X**X********X*****X***********X***********X*****X*****X********X*****X*****X**X
XXXX**X**X**X**X**XXXX**XXXX**X**XXXXXXX**X**XXXXXXX**X**X**X**XXXX**X**XXXX**X**X**X**X**X
X*****X**X**X*****X**************X*****X**X********X*****X***********X**X*****X*****X**X**X
X**XXXX**X**XXXXXXXXXXXXXXXXXXX**XXXX**X**XXXXXXX**XXXXXXXXXXXXXXXXXXX**X**XXXXXXXXXX**X**X
X********X********************X********X**X*****X**X********X**************X***********X**X
XXXX**XXXXXXXXXXXXX**XXXXXXX**XXXXXXXXXX**X**X**X**X**XXXX**X**XXXXXXX**XXXX**XXXXXXXXXX**X
X**X***********X*****X*****X**************X**X**X**X**X**X**X*****X**X*****X**X*****X*****X
X**XXXXXXXXXX**X**XXXXXXX**X**XXXXXXXXXXXXX**XXXX**X**X**X**XXXX**X**XXXX**X**X**X**X**X**X
X**************X***********X***********************X*****X********X********X*****X*****X***
XXXXXXXXXXXXXXXXXXXXXXXXXXXXXXXXXXXXXXXXXXXXXXXXXXXXXXXXXXXXXXXXXXXXXXXXXXXXXXXXXXXXXXXXXXX