********XXXXXXXXXXXXXX
X**XX***XXXXXXXX****XX
X**XX************XX*XX
**XXXXXXXXXXX****XX*XX
XXX******XXXXXXXXXX*XX
****XXXX**XXXXXXX***XX
X***XXXX************XX
X*XXXXXXXXXXXXXXXXXXXX
X*********************