XXXXXXXXXXXXXXXXXXXXXXXXXXXXXXXXXXXXXXXXXXXXXXXXXXXXXXXXXXXXXXXXXXXXXXXXXXXXXXXXXXXXXXXXXXXXXXXXXXXXXXXXXXXXXXXXXXXXXXXXXXXXXXXXXXXXXXXXXXXXXXXXXXXXXXXXXXXXXXXXXXXXXXXXXXXXXXXXXXXXXXXXXXXXXXXXXXXXXXXXXXXXXXXXXXXXXXXXXXXXXXXXXXXXXXXXXXXXXXXXXXXXXXXXXXXXXXXXXXXXXXXXXXXXXXXXXXXXXXXXXXXXXXXXXXXXXXXXXXXXX
***************X*****X***********X********X*****X***********X*****X**X***********X*****X*****X*****X*****X*****X**X********X********X***********************X***********************X**************X***********X********X*****X*****X**************X********X*****************X********************X*****X**X
XXXXXXXXXXXXX**X**X**X**XXXXXXX**XXXXXXX**X**XXXX**XXXXXXX**X**X**X**X**XXXX**XXXX**X**X**X**X**X**X**X**X**X**X**X**X**X**X**XXXX**X**XXXXXXX**XXXXXXXXXX**X**XXXXXXXXXX**XXXXXXX**X**XXXXXXXXXX**X**XXXXXXX**X**XXXX**XXXX**X**X**X**XXXXXXXXXX**X**XXXX**X**XXXX**XXXX**X**X**XXXXXXXXXX**XXXX**X**X**X**X
X*****X********X**X*****X*****X**X*****X**X*****X********X**X**X**X**X*****X********X*****X*****X*****X**X**X**X*****X**X**X**X**X**X**X*****X*****X*****X**X*****X*****X**X*****X**X**X*****X*****X*****X*****X*****X**X********X**X***********X**X**X*****X**X********X**X**X**X*****X*****X**X**X**X*****X
X**X**X**X**XXXX**XXXXXXXXXX**X**X**X**X**XXXX**XXXX**X**X**X**X**X**XXXX**XXXXXXXXXXXXXXXXXXXXXXXXXXXX**X**X**XXXXXXX**X**X**X**X**XXXX**X**XXXXXXX**X**X**X**XXXX**X**XXXX**X**X**X**X**XXXX**XXXXXXX**X**XXXXXXX**X**X**XXXXXXX**X**XXXXXXXXXX**X**X**XXXXXXX**XXXXXXX**X**X**X**X**X**XXXX**X**X**XXXXXXX
X**X**X**X*****X**X*****X*****X**X**X*****X*****X*****X**X**X**X********X*****************X*****X***********X***********X*****X**X********X*****X*****X*****X*****X**X********X**X*****X**X********X*****X*****X*****X**X**X**X*****X**X********X*****X**X********X*****X**X*****X**X*****X**X**X*****X*****X
X**X**X**XXXXXXX**X**X**X**XXXX**X**XXXXXXX**XXXX**XXXXXXX**X**XXXXXXX**XXXXXXXXXX**XXXX**X**XXXX**XXXX**XXXXXXXXXX**XXXXXXXXXX**XXXXXXXXXXXXX**X**XXXXXXXXXXXXX**X**X**XXXXXXX**XXXXXXX**X**XXXXXXX**XXXXXXX**X**XXXX**X**X**X**XXXXXXX**XXXX**X**XXXX**X**XXXXXXX**X**XXXXXXXXXX**XXXXXXX**X**X**XXXX**X**X
X**X**X*****X*****X**X********X*****X*****X********X********X********X***********X*****X**X**X*****X**X*****X*****X**************X**************X*****X*****X********X**X********X*****X*****X*****X**X*****X*****X*****X*****X**X********X**X*****X**X*****X********X**X********X**X********X*****X*****X**X
X**X**XXXX**X**XXXX**XXXXXXX**XXXX**X**X**XXXXXXXXXX**XXXX**XXXXXXX**XXXXXXXXXX**XXXX**X**X**X**XXXX**XXXX**X**X**XXXXXXXXXXXXX**X**XXXXXXXXXXXXXXXX**X**X**X**X**XXXX**X**XXXXXXX**X**XXXXXXX**X**X**XXXX**XXXXXXX**XXXXXXXXXX**X**XXXXXXX**XXXXXXX**XXXXXXX**XXXXXXX**X**XXXX**X**X**XXXXXXX**XXXX**XXXX**X
X**X*****X*****X***********X*****X*****X*****X*****X*****X********X**X*****X**X**X*****X**X*****X********X**X**X********X*****X**X*****X*****X*****X**X**X*****X*****X**X*****X*****X*****X*****X**X*****X********X**X********X**X**X*****X**X*****X*****************X********X*****X********X********X**X**X
X**XXXX**XXXXXXXXXXXXXXXX**XXXX**XXXXXXX**XXXX**X**XXXXXXXXXXXXX**XXXX**X**X**X**X**XXXX**X**XXXX**X**XXXX**X**XXXXXXX**X**X**XXXXXXX**X**X**XXXX**X**XXXXXXXXXXXXX**XXXXXXX**X**XXXXXXX**X**XXXX**XXXX**XXXXXXX**X**X**XXXX**X**X**XXXX**X**X**X**XXXXXXXXXX**XXXXXXXXXXXXX**XXXXXXXXXX**X**XXXXXXXXXX**X**X
X**X**X*****X*****X*****X**X*****X********X*****X**X***********X********X*****X**X*****X**X*****X**X**X*****X*****X*****X**X*****X*****X**X********X**************X*****X**X*****X********X*****X*****X********X*****X**X**X**X**X********X**X**X*****X********X*****X*****X*****X********X**X********X**X**X
X**X**XXXX**X**X**X**X**X**XXXXXXX**XXXXXXX**XXXX**X**XXXXXXX**XXXXXXXXXXXXX**X**XXXXXXX**XXXX**X**XXXX**XXXXXXXXXX**XXXX**XXXX**X**XXXXXXXXXX**XXXXXXX**XXXXXXX**XXXX**X**XXXXXXX**XXXXXXXXXX**XXXX**XXXXXXX**XXXXXXX**X**X**X**X**XXXXXXX**XXXX**XXXX**XXXXXXX**X**XXXX**XXXX**X**XXXXXXX**X**XXXX**X**X**X
X**X***********X**X**X***********X**X*****X**X*****X**X*****X********X**X*****X********X*****X*****X*****X********X**X**X**X*****X**X*****X*****X*****X********X*****X**X***********X********X*****X**X********X**X*****X***********X*****X**************X*****X**X*****X**X********X*****X*****X*****X*****X
X**XXXXXXXXXXXXXXXX**XXXX**XXXX**X**X**X**X**XXXXXXX**X**X**X**XXXX**X**X**XXXXXXXXXX**XXXX**XXXXXXX**XXXX**XXXX**X**X**X**XXXXXXX**XXXX**X**XXXXXXX**XXXXXXX**XXXXXXX**XXXXXXXXXXXXX**XXXX**XXXXXXX**XXXXXXX**X**X**XXXXXXX**X**XXXX**X**XXXXXXX**XXXXXXX**X**X**XXXX**X**XXXXXXXXXX**X**XXXXXXX**XXXXXXXXXX
X**X**X*****X********X**X**X**X*****X**X**X********X**X**X*****X*****X*****X*****X**X**X**X********X********X*****X**X**X********X*****X**X**X*****************X*****X**X*****X********X**X********X********X**X*****X**X*****X**X*****X********X***********X*****X**X*****X********X**X***********X********X
X**X**X**X**X**XXXXXXX**X**X**XXXXXXX**X**XXXXXXX**X**XXXXXXXXXXXXXXXX**XXXX**X**X**X**X**XXXXXXX**XXXXXXXXXX**XXXX**X**XXXX**X**XXXX**X**X**X**XXXX**XXXXXXXXXX**X**X**XXXX**XXXX**X**X**XXXXXXX**XXXXXXX**X**XXXXXXX**X**XXXX**X**XXXXXXXXXX**XXXX**XXXXXXXXXXXXX**XXXXXXX**XXXX**X**XXXXXXX**XXXX**XXXX**X
X********X*****X*****X*****X**X*****X**X********X********X*****X********X*****X**X**X***********X**X********X**X********X*****X*****X*****X**X**X*****X***********X*****************X**X********************X**X***********X*****X**X********X********X********X*****X*****X**X**X*****X*****X********X**X**X
XXXX**XXXXXXXXXXXXX**XXXXXXX**XXXX**X**XXXXXXX**XXXXXXX**X**X**X**XXXX**X**XXXX**X**XXXX**XXXX**X**X**XXXX**X**X**X**X**X**XXXXXXX**XXXXXXX**X**X**XXXX**XXXXXXXXXXXXXXXXXXX**XXXXXXXXXXXXXXXXXXX**XXXXXXXXXX**X**XXXXXXXXXX**XXXX**X**XXXX**XXXXXXXXXX**XXXX**X**XXXX**X**X**X**XXXXXXXXXX**XXXXXXX**X**X**X
X*****X*****X**************X**X*****X**X*****X*****X*****X**X**X*****X**X**X*****X********X*****X**X*****X**X*****X**X*****X********X*****X**X**X********X********************X********X***********X*****X*****X********X*****X*****X*****X**X*****X*****X*****X**X*****X**X*****************X**X*****X*****X
X**XXXX**XXXX**XXXXXXXXXX**X**X**XXXXXXX**X**XXXX**X**XXXXXXX**XXXX**XXXX**X**XXXXXXXXXXXXX**XXXX**XXXX**X**XXXXXXXXXXXXXXXX**XXXXXXX**X**X**X**X**XXXXXXXXXX**XXXXXXXXXXXXXXXXXXXXXX**X**XXXXXXXXXX**X**X**XXXXXXXXXXXXX**XXXX**XXXXXXXXXX**X**X**X**XXXX**XXXX**X**XXXX**XXXXXXXXXXXXXXXXXXX**X**XXXX**XXXX
X*****X*****X***********X**X**X********X**X***********X*****X*****X*****X**X*****X**X*****X*****X*****X**X********X***********X*****X**X********X**X********X**X*****X*****X***********X**X***********X*****X**************X*****X*****X*****X**X**X**X*****X*****X*****X*****X***********X**X*****X**X**X**X
XXXX**XXXX**XXXXXXX**XXXX**X**X**XXXX**X**XXXXXXX**XXXX**X**XXXX**XXXX**X**XXXX**X**X**X**X**X**XXXX**X**XXXXXXX**X**XXXXXXXXXX**XXXX**XXXX**XXXXXXX**XXXX**X**X**X**X**X**X**XXXXXXXXXX**X**XXXX**XXXXXXXXXX**XXXXXXXXXXXXX**XXXX**X**X**XXXX**X**X**X**XXXX**XXXXXXX**XXXX**XXXXXXXXXX**X**XXXXXXX**X**X**X
X********X***********X********X**X*****X**X*****X**X*****X*****X**X*****X**X*****X**X**X*****X***********X********X**************X*****X**X**X*****X**X**X**X**X**X**X**X**X**X*****X**X**X*****X**X*****************X********X*****X**X**X*****X*****X*****X**X*****X**X*****X*****X*****X*****X*****X**X**X
X**XXXX**XXXXXXXXXXXXX**XXXXXXX**X**XXXX**XXXX**X**X**XXXX**X**X**X**XXXX**X**XXXX**X**XXXXXXXXXXXXXXXXXXX**XXXXXXXXXXXXXXXXXXX**X**XXXX**X**X**X**X**X**X**X**X**X**XXXX**X**X**X**X**X**XXXXXXX**XXXXXXX**XXXXXXX**X**XXXXXXXXXXXXX**X**X**XXXXXXXXXXXXX**X**X**X**X**X**XXXX**X**X**XXXXXXX**X**XXXX**X**X
X*****X********X*****X*****X**X**X**X***********X**X*****X**X**X**X*****X**X**X*****X********X**X*****************X***********X***********X*****X*****X*****X*****X*****X********X**X*****X*****X**X********X*****X**X**X**************X*****X***********X*****X**X**X**X********X*****X********X********X**X
XXXX**X**XXXXXXX**X**XXXX**X**X**X**XXXX**XXXXXXX**XXXX**XXXX**X**XXXX**XXXX**XXXX**XXXXXXX**X**X**XXXXXXXXXXXXXXXX**X**X**XXXXXXXXXXXXXXXXXXXXXXXXXXXXXXXXXXXXXXXXXXX**XXXXXXXXXX**X**XXXX**X**X**X**XXXXXXXXXX**X**X**X**XXXX**XXXX**X**XXXX**XXXXXXX**XXXXXXX**X**X**X**XXXXXXX**X**X**XXXXXXXXXX**XXXX**X
X*****X*****X*****X********X*****X********X********X*****X***********X**************X********X*****X********X*****X**X**X*****X********X**************X**X***********X**X***********X*****X**X***********X*****X*****X**X**X********X**X*****X**X*****X***********X*****X********X**X**X**X*****X********X**X
X**XXXXXXX**X**XXXXXXX**XXXXXXXXXX**XXXXXXX**XXXXXXX**XXXX**X**XXXXXXXXXXXXX**XXXX**X**XXXXXXXXXX**X**XXXX**X**X**X**X**XXXX**X**XXXX**X**XXXXXXXXXX**X**X**XXXXXXX**X**X**XXXX**XXXXXXX**X**XXXX**XXXX**X**X**XXXXXXX**X**XXXX**X**XXXXXXX**X**XXXX**XXXXXXXXXXXXX**XXXXXXXXXX**X**XXXX**XXXX**X**XXXXXXX**X
X********X**X**X********X********X**X*****X**X*****X*****X**X*****X*****X*****X**X**X********X*****X*****X**X**X*****X*****X**X*****X**X**X*****X**X**X*****X********X**X**X**X**X*****X*****X**X**X*****X**X********X**X*****X**X*****X**X**X**X*****X***********X**X********X**X*****X**X*****X***********X
XXXXXXX**X**X**X**XXXXXXX**X**X**X**X**X**XXXX**X**XXXX**X**XXXXXXX**X**XXXXXXX**X**XXXX**X**XXXXXXX**X**X**X**XXXXXXXXXX**X**XXXXXXX**X**XXXX**X**X**XXXXXXXXXX**X**X**X**X**X**X**X**XXXXXXX**X**X**XXXX**XXXXXXX**X**X**X**X**XXXX**X**X**X**X**XXXX**XXXXXXX**X**X**XXXX**X**XXXX**X**X**XXXXXXXXXXXXXXXX
X*****X**X**X**X***********X**X**X**X**X*****X**X**X*****X********X**X**************X**X**X***********X**X*****X***********X**X********X**X********X***********X**X********X**X*****X**X***********X**X*****X*****X**X**X**X**X*****X**X*****X*****X*****X*****X**X**X*****X**X*****X**X*****X*****X*****X**X
X**X**X**XXXX**X**XXXXXXXXXX**XXXX**X**XXXX**XXXX**XXXXXXXXXXXXX**X**XXXXXXXXXXXXXXXX**X**XXXXXXXXXXXXXXXXXXXXXX**XXXXXXXXXX**X**X**XXXX**X**X**XXXXXXXXXXXXX**XXXXXXX**XXXX**XXXXXXX**X**XXXXXXXXXXXXX**XXXX**XXXX**X**XXXX**XXXX**X**X**XXXXXXXXXX**XXXX**X**X**X**XXXX**X**XXXX**X**X**XXXX**X**XXXX**X**X
X**X**X********X*****X*****X*****X********X**X*****X***********X**X*****X**************X*****X**************X*****X***********X**X**X**X*****X*****X********************X**X***********X**X*****X********X***********X********X**X**X*****X********X********X**X**X*****X**X********X********X**X**X*****X**X
X**XXXXXXXXXXXXXXXX**X**XXXXXXX**X**XXXX**X**X**XXXX**X**XXXX**X**X**X**X**XXXXXXX**XXXXXXX**X**XXXXXXXXXXXXX**XXXX**XXXXXXXXXXXXX**X**XXXXXXXXXX**X**XXXXXXX**X**XXXXXXX**XXXXXXX**XXXX**X**X**X**XXXXXXX**XXXXXXX**XXXXXXXXXX**X**X**XXXX**XXXX**XXXXXXXXXX**X**XXXX**X**XXXXXXXXXXXXXXXX**X**X**X**XXXX**X
X*****X**************X***********X**X**X**X*****X**X**X*****X*****X**X**X**X********X*****X**X***********X*****X**X*****X*****X*****X********X*****X*****X*****X**X*****X*****X**X**X**X*****X*****X*****X********X*****X***********X**X*****X*****X*****X*****X*****X**X*****X*****X*****X**X**X**X*****X**X
XXXX**X**XXXXXXXXXXXXXXXXXXXXXXXXX**X**X**XXXXXXX**X**XXXX**XXXXXXXXXX**X**X**XXXXXXX**X**X**XXXXXXXXXX**X**XXXX**XXXX**X**X**X**XXXX**X**X**X**XXXXXXX**X**XXXXXXX**X**XXXX**X**X**X**XXXX**XXXXXXX**XXXXXXXXXX**XXXX**X**XXXXXXXXXXXXX**XXXX**XXXX**X**XXXXXXX**XXXX**XXXX**X**X**XXXX**X**X**X**XXXX**X**X
X*****X********X********X***********X*****X********X*****X**X**************X***********X**X**X********X*****X*****X********X*****X*****X**X**X**X*****X**X********X**X********X**X**X********X********X***********X*****X*****X********X**X**X*****X**X**X**************X*****X**X********X**X**X*****X**X**X
X**XXXXXXXXXX**XXXXXXX**X**XXXXXXXXXXXXXXXX**X**XXXXXXX**XXXX**X**XXXX**XXXX**XXXXXXXXXX**X**X**XXXX**XXXXXXX**XXXXXXXXXXXXXXXXXXX**XXXXXXX**X**X**X**X**X**XXXX**X**XXXX**XXXX**X**X**XXXXXXX**XXXXXXX**XXXXXXXXXXXXX**XXXX**X**XXXX**X**X**XXXX**X**X**X**XXXX**XXXXXXX**XXXX**X**XXXXXXX**X**XXXX**X**X**X
X**X********X*****X**X**X***********X********X***********X*****X*****X*****X*****X*****X*****X*****X**X*****X**************X*****X**X*****X**X**X**X*****X*****X*****X*****X**X*****X*****X*****X********X***********X*****X**X**X********X********X**X**X**X*****X********X*****X********X*****X**X********X
X**X**XXXX**XXXX**X**X**XXXXXXXXXX**X**XXXXXXXXXXXXXXXXXXX**XXXXXXXXXXXXX**XXXX**X**X**XXXXXXXXXX**X**XXXX**XXXX**XXXXXXX**XXXX**X**X**X**XXXX**X**XXXXXXXXXXXXXXXXXXX**XXXX**XXXXXXX**X**XXXX**X**XXXXXXX**XXXXXXX**XXXX**X**X**XXXXXXXXXXXXX**X**X**X**X**X**XXXX**XXXXXXX**XXXXXXXXXX**XXXXXXX**XXXX**XXXX
X********X*****X*****X**X*****X*****X**X********X********X**X**************X**X*****X********X*****X********X**X*****X**X***********X**X********X*****X********X*****X*****X**X**X*****X**X*****X***********X**X*****X*****X**X**X*****X********X**X**X*****X*****X********X***********X**X*****X********X**X
XXXXXXX**XXXX**XXXX**X**X**X**X**XXXX**X**XXXX**X**XXXX**X**X**XXXXXXXXXXXXX**XXXXXXX**X**X**X**X**X**XXXXXXX**XXXX**X**XXXXXXXXXXXXX**XXXXXXXXXXXXX**X**XXXX**X**XXXX**X**X**X**X**XXXX**X**XXXXXXXXXXXXXXXX**X**XXXX**XXXX**X**X**XXXX**XXXX**X**X**XXXXXXXXXX**XXXXXXX**XXXXXXXXXX**X**X**X**XXXXXXXXXX**X
X********X*****X********X**X**X**X*****X**X**X*****X**X*****X**X*****************X*****X**X**X**X**X*****X***********************X**X********X********X*****X**X**X*****X*****X*****X**X*****X**************X********X*****X*****X*****X**X*****X**X**X***********X*****X**X***********X**X**X**X*****X**X**X
X**XXXXXXX**XXXX**X**XXXXXXX**X**X**XXXX**X**XXXXXXX**XXXXXXX**X**XXXXXXXXXX**XXXX**XXXX**X**X**X**XXXXXXX**XXXXXXXXXXXXXXXXXXX**X**XXXXXXX**X**XXXXXXX**XXXX**X**X**XXXXXXXXXXXXX**X**XXXXXXXXXX**XXXXXXX**XXXXXXX**X**XXXXXXXXXXXXX**X**XXXXXXX**X**X**XXXXXXXXXX**X**X**X**XXXXXXXXXX**XXXX**X**X**X**X**X
X********X*****X**X*****X*****X***********X********X**X*****X**X**X*****X*****X*****X*****X**X**X**X*****X********X*****X*****X**************X**X*****X**X*****X*****X*****X*****X**X**X***********X********X**X*****X**X***********X**X********X**X**X**X***********X**X***********X**X********X**X**X**X**X
XXXXXXX**XXXX**X**XXXX**X**XXXXXXX**XXXXXXXXXXXXX**X**XXXX**X**X**X**X**X**XXXX**XXXX**XXXX**X**XXXX**X**XXXXXXX**X**X**X**X**XXXXXXXXXXXXXXXX**X**XXXX**X**XXXXXXXXXXXXX**X**X**X**X**X**XXXXXXXXXX**XXXXXXX**X**XXXX**X**XXXXXXX**X**XXXXXXX**X**X**X**X**XXXXXXXXXX**XXXX**XXXX**X**XXXXXXXXXX**X**X**X**X
X**X*****X*****X**X*****X**X*****X********X*****X**X**X********X*****X**X**X*****X*****X**X**X********X**X*****X**X**X**X**X*****X********X**************X*****X*****X*****X**X**X**X**X*****X*****X**X***********X*****X**X********X**X*****X**X**X**X**X********X*****X*****X*****X**X***********X**X*****X
X**X**XXXX**X**X**X**XXXX**X**XXXXXXXXXX**XXXX**X**X**X**XXXXXXXXXXXXXXXX**XXXX**X**XXXX**X**XXXXXXXXXX**X**X**X**X**X**X**XXXX**XXXXXXX**X**XXXXXXXXXXXXXXXX**X**XXXX**XXXX**X**X**X**XXXX**X**X**X**X**XXXXXXXXXX**XXXXXXX**XXXXXXX**X**X**X**X**X**X**X**XXXX**XXXXXXX**XXXX**X**X**X**XXXX**XXXX**X**XXXX
X**X*****X**X*****X**X*****X**X*****X*****X*****X********X**************X********X*****X*****X***********X**X*****X**X**X**X*****X********X**X***********X*****X***********X**X**X*****X**X*****X**X**X********X*****X********X*****X**X**X*****X*****X**X**X**X***********X*****X**X**X**X**X**X*****X**X**X
X**XXXX**XXXXXXXXXX**X**XXXX**X**X**X**X**X**X**XXXXXXXXXX**XXXXXXXXXX**XXXXXXXXXXXXX**XXXX**X**XXXX**XXXX**X**XXXX**X**X**X**XXXX**XXXXXXXXXX**XXXXXXX**X**XXXXXXXXXX**X**X**X**XXXXXXX**XXXXXXX**X**XXXXXXX**X**XXXX**XXXX**XXXX**X**X**XXXXXXXXXXXXX**X**X**XXXXXXXXXXXXX**XXXX**X**X**X**X**X**X**X**X**X
X*****************X*****X*****X**X*****X**X**X*****X********X********X*****X***********X**X*****X**X**X*****X**X*****X*****X********X*****X*****X*****X*****X***********X**X**X***********X********X********X**X**X********X**X********X**X********X*****X*****************X**X********X**X**X**X**X**X**X**X
X**XXXX**XXXXXXX**XXXXXXXXXX**X**XXXXXXX**X**XXXX**XXXXXXX**X**XXXX**XXXX**X**XXXXXXXXXX**XXXXXXX**X**X**XXXX**X**XXXXXXXXXXXXXXXXXXX**X**X**XXXX**X**XXXXXXX**XXXXXXXXXX**X**X**XXXXXXXXXX**XXXXXXXXXXXXXXXX**X**X**XXXX**X**X**XXXXXXX**XXXX**X**X**XXXXXXXXXXXXXXXXXXX**X**XXXXXXXXXX**X**X**X**XXXX**X**X
X**X*****X***********X**X*****X********X*****X**X**X********X*****X*****X**X**X**X********************X*****X**X*****X*****X********X**X**X********X*****X*****X*****X*****X**X***********X***********X********X*****X*****X**X***********X*****X*****X*****X********X*****X********X*****X*****X*****X**X**X
XXXX**XXXX**XXXX**X**X**X**XXXXXXXXXX**XXXXXXX**X**X**XXXXXXXXXXXXXXXX**X**X**X**X**XXXXXXXXXXXXX**XXXXXXX**XXXXXXX**X**X**XXXXXXX**XXXX**XXXXXXXXXXXXX**X**XXXX**X**X**XXXX**XXXXXXXXXXXXXXXX**XXXX**X**X**XXXXXXXXXX**XXXXXXXXXXXXXXXXXXX**XXXXXXXXXXXXX**X**XXXX**X**XXXXXXXXXX**X**XXXXXXXXXX**X**X**X**X
X*****X**X**X*****X*****X**************X***********X*****X********X**X**X*****X*****X***********X**X*****X**************X*****X*****X*****X********X********X*****X**X**X*****X********X********X*****X**X*****X**X*****X**************X*****X***********X**X**X********X*****X**X*****X*****X*****X*****X**X
X**XXXX**X**XXXXXXXXXX**X**XXXXXXXXXXXXX**XXXXXXXXXXXXX**X**XXXX**X**X**XXXXXXXXXX**X**XXXXXXX**X**X**XXXXXXXXXXXXX**XXXXXXX**X**XXXX**XXXX**XXXX**X**X**XXXX**XXXX**X**X**XXXX**XXXX**X**XXXXXXXXXX**XXXXXXX**X**X**XXXX**XXXXXXXXXXXXX**XXXXXXX**XXXX**X**X**X**XXXX**XXXX**X**XXXXXXX**X**XXXXXXXXXXXXX**X
X*****X**X*****X*****X**X*****X***********X*****X********X*****X**X*****X***********X**X**X*****X**X**X*****X*****X********X********X**X*****X*****X**X**X*****X*****X**X********X**X*****X*****X*****X********X**X********X**************X********X**X**X*****X*****X********X********X**X********X*****X**X
X**X**X**X**X**X**X**X**XXXX**X**XXXXXXXXXXXXX**X**X**XXXXXXX**X**X**XXXX**XXXXXXXXXX**X**X**XXXX**X**X**X**X**X**X**XXXX**XXXX**XXXX**X**XXXXXXXXXX**X**X**XXXX**XXXX**XXXXXXXXXX**XXXXXXX**X**X**X**X**XXXXXXX**XXXX**XXXX**XXXXXXXXXXXXX**XXXXXXX**X**XXXXXXXXXX**X**XXXXXXXXXXXXX**X**XXXX**X**X**X**X**X
X**X*****X**X*****X**X********X*****************X**X***********X********X**************X*****X*****X*****X*****X*****X********X********X**************X*****X*****X**************X***********X*****X**************X********X***********************X*****X***********X********************X*****X*****X******
XXXXXXXXXXXXXXXXXXXXXXXXXXXXXXXXXXXXXXXXXXXXXXXXXXXXXXXXXXXXXXXXXXXXXXXXXXXXXXXXXXXXXXXXXXXXXXXXXXXXXXXXXXXXXXXXXXXXXXXXXXXXXXXXXXXXXXXXXXXXXXXXXXXXXXXXXXXXXXXXXXXXXXXXXXXXXXXXXXXXXXXXXXXXXXXXXXXXXXXXXXXXXXXXXXXXXXXXXXXXXXXXXXXXXXXXXXXXXXXXXXXXXXXXXXXXXXXXXXXXXXXXXXXXXXXXXXXXXXXXXXXXXXXXXXXXXXXXXXXX*