********#############@
#####***########****##
#####************##*##
#############****##*##
#################***##
#*******************##
#*####################
#*********************